AD=Andorran
AE=Emirati
AF=Afghan
AG=Antiguan, Barbudan
AI=Anguillian
AL=Albanian
AM=Armenian
AO=Angolan
AQ=Antarctican
AR=Argentine
AS=American Samoan
AT=Austrian
AU=Australian
AW=Aruban
AX=Ålandish
AZ=Azerbaijani
BA=Bosnian, Herzegovinian
BB=Barbadian
BD=Bangladeshi
BE=Belgian
BF=Burkinabe
BG=Bulgarian
BH=Bahraini
BI=Burundian
BJ=Beninese
BL=Saint Barthélemy Islander
BM=Bermudian
BN=Bruneian
BO=Bolivian
#BQ=Dutch
BR=Brazilian
BS=Bahamian
BT=Bhutanese
BW=Motswana
BY=Belarusian
BZ=Belizean
CA=Canadian
CC=Cocos Islander
CD=Congolese
CF=Central African
#CG=Congolese
CH=Swiss
CI=Ivorian
CK=Cook Islander
CL=Chilean
CM=Cameroonian
CN=Chinese
CO=Colombian
CR=Costa Rican
CU=Cuban
CV=Cape Verdian
CW=Curaçaoan
CX=Christmas Islander
CY=Cypriot
CZ=Czech
DE=German
DJ=Djibouti
DK=Danish
#DM=Dominican
DO=Dominican
DZ=Algerian
EC=Ecuadorean
EE=Estonian
EG=Egyptian
EH=Sahrawi
ER=Eritrean
ES=Spanish
ET=Ethiopian
FI=Finnish
FJ=Fijian
FK=Falkland Islander
FM=Micronesian
FO=Faroese
FR=French
GA=Gabonese
GB=British
GD=Grenadian
GE=Georgian
GF=Guianan
#GG=Channel Islander
GH=Ghanaian
GI=Gibraltar
GL=Greenlandic
GM=Gambian
GN=Guinean
GP=Guadeloupian
GQ=Equatorial Guinean
GR=Greek
GS=South Georgian South Sandwich Islander
GT=Guatemalan
GU=Guamanian
GW=Guinea-Bissauan
GY=Guyanese
HK=Hong Konger
HM=Heard and McDonald Islander
HN=Honduran
HR=Croatian
HT=Haitian
HU=Hungarian
ID=Indonesian
IE=Irish
IL=Israeli
IM=Manx
IN=Indian
#IO=Indian
IQ=Iraqi
IR=Iranian
IS=Icelander
IT=Italian
JE=Channel Islander
JM=Jamaican
JO=Jordanian
JP=Japanese
KE=Kenyan
KG=Kirghiz
KH=Cambodian
KI=I-Kiribati
KM=Comoran
KN=Kittitian or Nevisian
KP=North Korean
KR=South Korean
KW=Kuwaiti
KY=Caymanian
KZ=Kazakhstani
LA=Laotian
LB=Lebanese
LC=Saint Lucian
LI=Liechtensteiner
LK=Sri Lankan
LR=Liberian
LS=Mosotho
LT=Lithuanian
LU=Luxembourger
LV=Latvian
LY=Libyan
MA=Moroccan
MC=Monegasque
MD=Moldovan
ME=Montenegrin
MF=Saint Martin Islander
MG=Malagasy
MH=Marshallese
MK=Macedonian
ML=Malian
MM=Burmese
MN=Mongolian
MO=Macanese
#MP=American
MQ=Martinican
MR=Mauritanian
MS=Montserratian
MT=Maltese
MU=Mauritian
MV=Maldivan
MW=Malawian
MX=Mexican
MY=Malaysian
MZ=Mozambican
NA=Namibian
NC=New Caledonian
NE=Nigerien
NF=Norfolk Islander
NG=Nigerian
NI=Nicaraguan
NL=Dutch
NO=Norwegian
NP=Nepalese
NR=Nauruan
NU=Niuean
NZ=New Zealander
OM=Omani
PA=Panamanian
PE=Peruvian
PF=French Polynesian
PG=Papua New Guinean
PH=Filipino
PK=Pakistani
PL=Polish
PM=Saint-Pierrais, Miquelonnais
PN=Pitcairn Islander
PR=Puerto Rican
PS=Palestinian
PT=Portuguese
PW=Palauan
PY=Paraguayan
QA=Qatari
RE=Réunionese
RO=Romanian
RS=Serbian
RU=Russian
RW=Rwandan
SA=Saudi Arabian
SB=Solomon Islander
SC=Seychellois
SD=Sudanese
SE=Swedish
SG=Singaporean
SH=Saint Helenian
SI=Slovene
#SJ=Norwegian
SK=Slovak
SL=Sierra Leonean
SM=Sammarinese
SN=Senegalese
SO=Somali
SR=Surinamer
SS=South Sudanese
ST=Sao Tomean
SV=Salvadoran
SX=St. Maartener
SY=Syrian
SZ=Swazi
TC=Turks and Caicos Islander
TD=Chadian
#TF=French
TG=Togolese
TH=Thai
TJ=Tadzhik
TK=Tokelauan
TL=East Timorese
TM=Turkmen
TN=Tunisian
TO=Tongan
TR=Turkish
TT=Trinidadian
TV=Tuvaluan
TW=Taiwanese
TZ=Tanzanian
UA=Ukrainian
UG=Ugandan
UM=American Islander
US=American
UY=Uruguayan
UZ=Uzbekistani
VA=Vatican
VC=Saint Vincentian
VE=Venezuelan
VG=British Virgin Islander
VI=American Virgin Islander
VN=Vietnamese
VU=Ni-Vanuatu
WF=Wallis and Futuna Islander
WS=Samoan
YE=Yemeni
YT=Mahoran
ZA=South African
ZM=Zambian
ZW=Zimbabwean